################
#      @       #
#              #
#              #
#      X       #
#              #
#              #
#              #
#              #
#              #
#      C       #
#              #
#              #
#              #
#              #
################
