################
#  L   @       #
#              #
#              #
#      X       #
#              #
# V         G  #
#              #
#              #
#              #
#      C       #
#              #
#              #
#              #
#              #
################
