################
#      @       #
#LLLL   GGG    #
#              #
#    XcVVVV    #
#              #
#         V    #
#   s c        #
#        V     #
#              #
#       s      #
#              #
#              #
#              #
#              #
################
