################
#      @       #
#         G    #
#              #
#      X       #
#              #
#         C    #
#              #
#   d    C     #
#              #
#     d        #
#              #
#              #
#              #
#              #
################
