################
#      @       #
#        GG    #
#              #
#      X       #
#              #
#              #
#   s     d    #
#              #
#              #
#              #
#              #
#              #
#              #
#              #
################
