################
#      @    O  #
#  V     G     #
#          L   #
#      X       #
#              #
#              #
#              #
#              #
#              #
#      C       #
#              #
#              #
#              #
#              #
################
