################
#      @       #
#         G    #
#              #
#      X       #
#              #
#         C    #
#              #
#   s    C     #
#              #
#     s        #
#              #
#              #
#              #
#              #
################
